Namun	CC
aparat	NN
yang	PRL
berjaga	VB
langsung	RB
sigap	NN
dan	CC
menangkap	VB
kedua	NN
orang	NN
itu	DT
.	Z

''	Z
Nantilah	NN
,	Z
saya	PRP
lapor	VB
dulu	NN
,	Z
''	Z
ujarnya	SP
singkat	JJ
seraya	CC
memasuki	VB
gerbang	NN
.	Z

Direktur	NNP
Reskrimum	NNP
Polda	NNP
Metro	NNP
Jaya	NNP
Kombes	NNP
Krishna	NNP
Murti	NNP
mengatakan	VB
,	Z
pihaknya	NN
tengah	RB
memproses	VB
surat	NN
untuk	IN
red	FW
notice	FW
tersebut	VB
.	Z

Dua	CD
saudara	NN
laki-lakinya	NN
yang	PRL
lain	JJ
,	Z
yakni	SC
Seyfullah	NNP
dan	CC
Hasbi	NNP
,	Z
telah	RB
meninggal	VB
dunia	NN
.	Z

Belum	RB
diketahui	VB
apakah	WH
peristiwa	NN
itu	DT
merupakan	MD
kecelakaan	NN
atau	CC
bunuh	VB
diri	NN
.	Z

Kan	RB
dihitung	VB
sejak	IN
PP	NNP
itu	DT
dikeluarkan	VB
,	Z
''	Z
kata	VB
Ketua	NNP
Komisi	NNP
III	CD
(	Z
Hukum	NNP
)	Z
DPR	NNP
Gede	NNP
Pasek	NNP
Suardika	NNP
kepada	IN
wartawan	NN
di	IN
Gedung	NNP
DPR	NNP
,	Z
Senayan	NNP
,	Z
Jakarta	NNP
,	Z
Senin	NNP
(	Z
15/7/2013	SYM
)	Z
.	Z

Jadi	SC
sekarang	NN
tinggal	VB
masa	NN
pemulihan	NN
,	Z
''	Z
kata	VB
Vivi	NNP
.	Z

Jadi	SC
sekarang	NN
tinggal	VB
masa	NN
pemulihan	NN
,	Z
''	Z
kata	VB
Vivi	NNP
.	Z

Cross	NNP
Country	NNP
(	Z
XC	NNP
Cycling	NNP
)	Z
yang	PRL
cukup	JJ
populer	JJ
di	IN
kalangan	NN
pecinta	NN
extreme	FW
sport	FW
dan	CC
diperlombakan	VB
sejak	IN
tahun	NN
1996	CD
di	IN
ajang	NN
extreme	FW
olympiade	FW
ini	DT
akan	RB
digelar	VB
di	IN
Taman	NNP
Safari	NNP
II	CD
Prigen	NNP
,	Z
Pasuruan	NNP
,	Z
Jawa	NNP
Timur	NNP
.	Z

Itu	PRD
tuh	UH
di	IN
seberang	NN
jalan	NN
Anda	PRP
sebaiknya	RB
menyeberang	VB
dari	IN
jembatan	NN
penyeberangan	NN
itu	DT
.	Z

Bulan	NN
Oktober	NNP
2012	CD
,	Z
sang	DT
korban	NN
melapor	VB
ke	IN
polisi	NN
soal	NN
tindakan	NN
mereka	DT
dahulu	NN
.	Z

Tujuannya	NN
untuk	IN
memantapkan	VB
konsolidasi	NN
kultural	JJ
dengan	IN
memaksimalkan	VB
peran	NN
ulama	NN
dan	CC
kiai	NN
.	Z

''	Z
Kita	PRP
strategi	NN
perang	NN
jarak	NN
pendek	JJ
,	Z
bukan	RB
panah	JJ
,	Z
bukan	RB
tombak	NN
,	Z
tapi	CC
dengan	IN
belati	NN
dan	CC
pisau	NN
dapur	NN
,	Z
''	Z
tuturnya	SP
.	Z
